NO textures/test/north.xpm
SO textures/test/south.xpm
WE textures/test/west.xpm
EA textures/test/east.xpm
F 220,100,0
C 225,30,0

 1111111111111111111111
100000000000S00000000001
 1000000000000000000001
  10000000000000000001
   100000000000000001
    1000000000000001
     10000000000001
      100000000001
       1000000001
        10000001
         101001
          1001
           11
