NO textures/simonkraft/cobblestone.xpm
SO textures/simonkraft/mossy_cobblestone1.xpm
WE textures/simonkraft/soul_sand.xpm
EA textures/simonkraft/respawn_anchor_side0.xpm
F 100,100,100
C 50,50,200

1111111111111
1000000000001
100N000000001
1000000000001
1111111111111
